#B#     ##
# # ### ##
# # ##  ##
#   ### ##
### ### ##
###   # ##
######  ##
#####A  ##
